あ
ア		い
イ	う
ウ	え
エ	お
オ
か
カ	き
キ	く
ク	け
ケ	こ
コ
さ
サ	し
シ	す
ス	せ
セ	そ
ソ
た
タ	ち
チ	つ
ツ	て
テ	と
ト
な
ナ	に
ニ	ぬ
ヌ	ね
ネ	の
ノ
は
ハ	ひ
ヒ	ふ
フ	へ
ヘ	ほ
ホ
ま
マ	み
ミ	む
ム	め
メ	も
モ
や
ヤ		ゆ
ユ		よ
ヨ
ら
ラ	り
リ	る
ル	れ
レ	ろ
ロ
わ
ワ				を
ヲ
ん
ン				
が	ぎ	ぐ	げ	ご
ざ	じ	ず	ぜ	ぞ
だ	ぢ	づ	で	ど
ば	び	ぶ	べ	ぼ
ぱ	ぴ	ぷ	ぺ	ぽ

きゃ	きゅ	きょ
しゃ	しゅ	しょ
ちゃ	ちゅ	ちょ
にゃ	にゅ	にょ
ひゃ	ひゅ	ひょ
みゃ	みゅ	みょ
りゃ	りゅ	りょ
ぎゃ	ぎゅ	ぎょ
じゃ	じゅ	じょ
びゃ	びゅ	びょ
ぴゃ	ぴょ	ぴょ

